30
30
海海海草草草草海海海海海海海海海海海海海海海海草草草草海海海
海草草草木草草岩草海海海海海海海海海海海海草草草木草草岩草海
草草草草草草草草花草海海海海海海海海海海草草草草草草草草花草
草草草草草草草草草草海海海海海海海海海海草草草草草草草草草草
木草草草草草草草草草海海海海海海海海海海草草草草草草草草草草
草草草草草草草草草草海海海海海海海海海海草草草草草草草草草草
草草草草草草草草草草海海海海海海海海海海草草草草草草草草草草
草花草草草草草草草草海海海海海海海海海海草花草草草草草草草草
海草草草草花草草草海海海海海海海海海海海海草草草草花草草草海
海海海草草草草海海海海海海海海海海海海海海海海草草草草海海海
海海海海丸丸海海海海海海海海海海海海海海海海海海丸丸海海海海
海海海海丸丸海海海海海海海埋埋埋埋海海海海海海海丸丸海海海海
海海海海丸丸海海海海海海埋埋埋埋埋埋海海海海海海丸丸海海海海
海海海海丸丸海海海海海埋埋埋埋埋埋埋埋海海海海海丸丸海海海海
海海海海丸丸丸丸丸丸丸埋埋埋海海埋埋埋丸丸丸丸丸丸丸海海海海
海海海海丸丸丸丸丸丸丸埋埋埋海海埋埋埋丸丸丸丸丸丸丸海海海海
海海海海丸丸海海海海海埋埋埋埋埋埋埋埋海海海海海丸丸海海海海
海海海海丸丸海海海海海海埋埋埋埋埋埋海海海海海海丸丸海海海海
海海海海丸丸海海海海海海海埋埋埋埋海海海海海海海丸丸海海海海
海海海海丸丸海海海海海海海海海海海海海海海海海海丸丸海海海海
海海海草草草草海海海海海海海海海海海海海海海海草草草草海海海
海草草草木草草岩草海海海海海海海海海海海海草草草木草草岩草海
草草草草草草草草花草海海海海海海海海海海草草草草草草草草花草
草草草草草草草草草草海海海海海海海海海海草草草草草草草草草草
木草草草草草草草草草海海海海海海海海海海木草草草草草草草草草
草草草草草草草草草草海海海海海海海海海海草草草草草草草草草草
草草草草草草草草草草海海海海海海海海海海草草草草草草草草草草
草花草草草草草草草草海海海海海海海海海海草花草草草草草草草海
海草草草草花草草草海海海海海海海海海海海海草草草草花草草草海
海海海草草草草海海海海海海海海海海海海海海海海草草草草海海海
5 3 Millet.chara
4 7 Monet.chara
4 2 board.thing
16 14 Gauguin.chara
9 15 item1.thing